Username,Transaction ID,Transaction Type,Amount,Description,Date,Balance,Category
ccyenoc,TS000001,Debit,1000.00,living,Fri Jan 10 22:37:35 GMT+08:00 2025,1000.00,Food
ccyenoc,TS000002,Credit,10.00,"food,living",Fri Jan 10 22:37:44 GMT+08:00 2025,990.00,Food
ccyenoc,TS000003,Credit,20.00,living,Fri Jan 10 22:38:21 GMT+08:00 2025,970.00,Food
ccyenoc,TS000004,Credit,20.00,living,Fri Jan 10 22:38:34 GMT+08:00 2025,950.00,Food
ccyenoc,TS000005,Credit,20.00,living,Fri Jan 10 22:38:49 GMT+08:00 2025,930.00,Food
ccyenoc,TS000006,Credit,20.00,living,Fri Jan 10 22:39:21 GMT+08:00 2025,910.00,Food
ccyenoc,TS000007,Credit,20.00,LIVING,Fri Jan 10 22:39:32 GMT+08:00 2025,890.00,Food
ccyenoc,TS000008,Debit,1000.00,loan,Fri Jan 10 22:47:28 GMT+08:00 2025,1890.00,